SO ./path_to_the_south_texture
R 1920 1081

C 255,0,0
NO           ./path_to_the_north_texture
WE ./path_to_the_west_texture
EA                         ./path_to_the_east_texture

S ./path_to_the_sprite_texture
F 00,255,255

11111111111111111111111111111111
10000000000000000000000000000001
10000000000000000000000000000001
10000000000000000000000000000001
10000000000000000000000000000001
10000000000000000000000000000001
10000000000000000000000000000001
10000000000000000000000000000001
10000000000000000000000000000001
10000000000000000000000000000001
10000000000000000000000000000001
10000000000000000000000000000001
10000000000000000000000000000001
10000000000000000000000000000001
10000000000000000000000000000001
11111111111111111111111111111111
