R 1910 1081

SO sources/texture/eagle.xpm
WE sources/texture/greystone.xpm
NO sources/texture/redbrick.xpm
EA sources/texture/wood.xpm

S ./path_to_the_sprite_texture

1111111111111111111111111111111111111111
1000010000000000000000000000000000000001
1000010000000000000000000000001000000001
1000000000000001000000000000001000000001
10000000000000000000000000000010000000011111111111111111111111
10000000000000000000000000000011111110000000000000000000000001
10000000000000000000000000000010000000011111111111000010010001
1000000000000100000000000000001000000001         1000000000001
1000000000000000000000000000001000000001         1111101111111
1000000000000000000000000000001011111111             101
10000000000000000000000000000010000000011111111111111101
10000000000000000010000000000010000000000000000000000001
10000000000000000000000000000010000000011111111111111111
100100000000000011111111110000100000000111
1000000000000000100000000000001000011001
100000000000000010001000000000100001100111
1111111111111111111111111111111111111111
