SO ./path_to_the_south_texture
R 1920 1080

C 255, 30,0
NO           ./path_to_the_north_texture
WE ./path_to_the_west_texture
EA                         ./path_to_the_east_texture

S ./path_to_the_sprite_texture
F 124,30,            221

111111	11111
100001	10001
111111	11111
				1111111
				1000001
				1111111
