SO./path_to_the_south_texture
R 1910 1081

NO ./path_to_the_north_texture
WE ./path_to_the_west_texture
EA ./path_to_the_east_texture

S ./path_to_the_sprite_texture

1111111111111111111111111111111111111111
1000010000000000000000000000000000000001
1000010000000000000000000000001000000001
1000000000000001000000000000001000000001
1000000000000000000000000000001000000001
1000000000000000000000000000001111111001
1000000000000000000000000000001000000001
1000000000000100000000000000001000000001
1000000000000000000000000000001000000001
1000000000000000000000000000001011111111
1000000000000000000000000000001000000001
1000000000000000001000000000001000000001
1000000000000000000000000000001000000001
1001000000000000111111111100001000000001
1000000000000000100000000000001000011001
1000000000000000100010000000001000011001
1111111111111111111111111111111111111111
