SO./path_to_the_south_texture
R 1910 1081

NO ./path_to_the_north_texture
WE ./path_to_the_west_texture
EA ./path_to_the_east_texture

S ./path_to_the_sprite_texture

11111111111111111111111111111
10000000000000000000000000001
10000000000000000000000000001
10000000000000010000000000001
10000000000000000000000000001
10000000000000000000000000001
10000000000000000000000000001
10000000000001000000000000001
10000000000000000000000000001
10000000000000000000000000001
10000000000000000000000000001
10000000000000000010000000001
10000000000000000000000000001
10010000000000001111111111001
10000000000000001000000000001
10000000000000001000100000001
11111111111111111111111111111
