R 1910 1081
 
F 51,204,255
C 0, 154 , 236

WE sources/texture/greystone.xpm
NO sources/texture/redbrick.xpm
EA sources/texture/wood.xpm
SO sources/texture/eagle.xpm
S sources/texture/barrel.xpm

1111111111111111111111111111111111111111111111111111111111111111111111111111111
1000001010001000001000001010000010101000000000000000000000000000000000000000001
100000101011111010111110101110101010100000000000000000000000000000W000000000001
1010100010000010001010100010100010001000000000000000000000000000000000000000001
1010111011101011111010101010111010101000000000000000000000000000000000000000001
1010001010000010100010101000100000101000000000000000000000000000000000000000001
1010111011111110101010111110111111101000000000000000000000000000000000000000001
1010000000101010000000100010101000000000000000000000000000000000000000000000001
1011101111101011111111111010101110101000000000000000000000000000000000000000001
1000100000001000101000001010001010101000000000000001110000000000000000000000001
1110111111101010101111101010111011111000000000000001011000000000000000000000001
10000010000010100000000010100010000000000000000100011111100000000000000000000001
1111101111101110101111101010101111111000000000000001111100000000000000000000001
1010001000100000101000101000001000100000000000000001011000000100000000000000001
1011101010101111111010101111111010101000000000000001110000000000000000000000001
1000000010101010000000100000000010001000000000000000000000000000000000000000001
1111111110111010101111101111111111111000000000000000000000000000000000000000001
1010001000101000100000101010000010100000000000000000000000000000000000000000001
1010111110101011111111101010111110101000000000000000000000000000000000000000001
1010000000100010001000100000001000101000000000000000000000000000000000000000001
1010111011111110101011111110111110111000000000000000000000000000000000000000001
1000101000101000100000001000000000101000000000000000000000000000000000000000001
1110101110101111111110101011111110101000000000000000000000000000000000000000001
1010101000100000001000101010100010000000000000000000000011101000000000000000001
1010101010101110111111101110111011101000000000000000000010000000000000000000001
1000001000000010101000101000000010101000000000000000000011111000000000000000001
1110101011111110101110101110101110101000000000000000000000000000000000000000001
1000101010100010000000000000100000101000000000000000000000000000000000000000001
1111101110101011101111101010101111101000000000000000000000000000000000000000001
1010100010100000100010001000101000001000000000000000000000000000000000000000001
1010101110111111111011101111111110111000000000000000000000000000000000000000001
1000100010000000101010000010101000001000000000000000000111111000000000000000001
1011111011101110101110111110101011111000000000000000000100000000000000000000001
1010101010001000001000100010000000101000000000000000000101100000000000000000001
1010101011111110111110101010101010101000000000000000000100000000000000000000001
1010000010000000101010001000001010101000000000000000000111110000000000000000001
1011101011111110101011101111111011101000000000000000000000000000000000000000001
1010001000001000101000000010100010001000000000000000000000000000000000000000001
1011101110111011101111111010111110111000000000000000000000000000000000000000001
1000101000001010001000000000101000101000000000000000000000000000000000000000001
1011111010111011101111111111101110101000000000000000000000000000000000000000001
1000100000101010100000101010100010101000000000000000000000000000000000000000001
1110101110101010111110101010111010101000000000000000000000000000000000000000001
1000001000001010001010001000101000001000000000000000000000000000000000000000001
1111101110101010101010101010101011101000000000000000000000000000000000000000001
1000001010100000101000100010001010100000000000000000000000000000000000000000001
1011101011111111101111111011101010111000000000000000000000000000000000000000001
1010101000000010000000000000101000100000000000000000000000000000000000000000001
1010101111111010111010101111101111111000000000000000000000000000000000000000001
1000101010001000001010001000001000100000000000000000000000000000000000000000001
1111101011101111111011101110101010111000000000000000000000000000000000000000001
1000101010000000001010100010101000100000000000000000000000000000000000000000001
1110101010101011111110101111111111101000000000000000000000000000000000000000001
1000101000101000100010100010001000000000000000000000000000000000000000000000001
1110101111111011101010111111101111111000000000000000000000000000000000000000001
1010001000100010100010100010101000000000000000000000000000000000000000000000001
1011101010111010111110101110101010101000000000000000000000000000000000000000001
1010001000001000001010101010100010101000000000000000000000000000000000000000001
1011101010101111101010101010101011111000000000000000000000000000000000000000001
1010101010101000100010100010001010100000000000000000000000000000000000000000001
1010101111111011101110101011111010111000000000000000000000000000000000000000001
1000001000101010000000101000100000100000000000000000000000000000000000000000001
1111101010101011111011111110111111101000000000000000000000000000000000000000001
1010001010000010000010001000001000001000000000000000000000000000000000000000001
1010101010111010101011101111101110111000000000000000000000000000000000000000001
1000101010101010101000000010101000100000000000000000000000000000000000000000001
1111101111101011111111111010101011101000000000000000000000000000000000000000001
1010101010100000100010001010101010101000000000000000000000000000000000000000001
1010101010111110101010101010101110111000000000000000000000000000000000000000001
1000001000101000000010101010001000101000000000000000000000000000000000000000001
1111101010101111101011101010101110101000000000000000000000000000000000000000001
1000100010000010001010100000100010000000000000000000000000000000000000000000001
1010111111111011101110101110111110101000000000000000000000000000000000000000001
1010100010100010001000001000000010101000000000000000000000000000000000000000001
1010101110111010101110101011101010111000000000000000000000000000000000000000001
1010101010101010100000101010000000001000000000000000000000000000000000000000001
1110101010101010111110101111101110101000000000000000000000000000000000000000001
1000000000000000100000101000001000000000000000000000000000000000000000000000001
1111111111111111111111111111111111111111111111111111111111111111111111111111111
