R 1910 1081
 
F 51,204,255
C 255, 0 , 0

WE sources/texture/greystone.xpm
NO sources/texture/redbrick.xpm
EA sources/texture/wood.xpm
SO sources/texture/eagle.xpm

S ./path_to_the_sprite_texture

11111111111111111111111111111111111111111111111111111111111111111111
10000000000000000000000000000000000000000000000000000000000000000001
11111100000000000000000000000010000000011111111111110111111111111101
1000000000000001000000000020001000000001           101           101
10000000000000000200000000000010000000011111111111110111111111   101
10000000000000N00000000000000111111100000000000000000000000001   101
10000000000000000000000000000010000000011110111111000010010001111101
100000000000010100000000000000100000000111101    1000000000000000001
100000000000011100000000000000100000000100001    1111101111111111101
100000000000000000000000000000101111111111101        101         101
10000000000000000000000000000001000000001110111111111101         101
10000000000000000010000000000010000000000000000000000001         101
10000000000000000000000000000010000000011111111111111111         101
10010000000000001111111111000010000000011111111111111111111111111101
10000000000000001000000000000010000110000000000000000000000000000001
10000000000000001000100000000010000110011111111111111111111111111111
1111111111111111111111111111111111111111
